A,1,Poor,5,0
A,2,Poor,5,0
A,3,Good,3,0
A,4,Good,3,0
A,5,Poor,5,0
A,6,Good,3,0
A,7,Poor,5,0
A,8,Good,3,0
A,9,Poor,5,0
A,10,Good,3,0
B,1,Poor,5,0
B,2,Good,3,0
B,3,Poor,5,0
B,4,Good,3,0
B,5,Poor,5,0
B,6,Good,3,0
B,7,Poor,5,0
B,8,Good,3,0
B,9,Poor,5,0
B,10,Good,3,0
C,1,Poor,5,0
C,2,Good,3,0
C,3,Poor,5,0
C,4,Good,3,0
C,5,Poor,5,0
C,6,Good,3,0
C,7,Poor,5,0
C,8,Good,3,0
C,9,Poor,5,0
C,10,Good,3,0
